##################
#S''''''''#'''''ER
####''##'''''''''R
#''''X'''''''''''R
#''''''''#'''''''R
#''''''''X'''''''R
#'''X'''#''''''''R
#''''''T'TX''''''R
#''''''''''''''''R
#''''T''E''''''''R
#X'X''''''''#''''R
#'''''''''#''''''R
#'''#''''''X'''''R
#''''''''''''T'''R
#''X''''#''''''''R
#''''''''X'''''''R
#''''''#'''''''''R
##################